sn. † ln nomine domini dei salvatoris nostri Ibesu Christi imperante dondno
990. nostro besilio magno Imperatore anno tricesimo: sed et constantino magno
Imperatore frater eius: anno vicesimo septimo: die nona mensis martii indi-
ctione: tertia neapoli: Certum est nos stephano filium quondam leoni et gre-
gorio boc est genitore et filio: nos memorato genitori et tilio: una cnm oon·
sensum eufimmia nuru: et cognata nostra: qui brit conius quondam mertini
filio et germano nostro: avitatoribus: deloco qui nominatur galloro: a prc-
senti die: proptissimn voluntatem : Venur'ndedimus et tradidimus tivi domino
sergio venerabili presbiterum: filium quondam idest una petia dc
terra nostra: que nominatur: nepotianum posita: in memorato loco: scu:
venundedimus tivi et portione nostra: de undum commune: nostrum: etde
aliis bominibus: posita in eodem loco una cum arboribus et introitus earum:
et omnibns sivi pertinentibus qui coberet et memorate petia de terra: ab
una perte terra ecclesia sancti severi: ab alia parto ooberet terra de illu
palamenestra: ab adia parte coheret terra de illu pantaleone: sicuti interce
sepis et fossatus exfinat: ab alia parte terra de memorate eeclesia sancti
severi: Unde nihil novis exinde: aliquod remansit: out reserbarimns: nec
in aliena cuiusque persona: quod apsit commisimus aut iam commissimus
potestatem: set a presenti die: et deinceps: enoris tiri sit iilos venum-
datum et traditum: in tua tuisque heredibus sit potestatem quidquid exindo
iacere volueritis: semper liberam abeatis potestatem: et nequo a novis neque
a nostris: heredibus nec a novis personis summissis nullo tempore: nuc-
· , - quam tu memorato domino sergio presbiterum: aut tuis heredibus: quod
:psit arentis exinde: quacumque requisitione aut molestia a nuncet inper-
petuis temporibus: insuper et ab omni bomine omnique persona: omni
tempore : nos memorato genitore ct filio heredibus nostris: tivi tuisque be-
redibus: illos in omnibus antestare et defensare deveamus: propter quod
accepimus a te exinde: idest nuri tari triidecim: sicut inter novis combenit:
si autem aliter fecerimus de is omnibus memoratis per quovis modum aut
summissis personis: tunc componimus nos et heredibus nostris : tivi tuisque
heredibus: auri solidos decem sptbianteos: et hcc chartula venditionis nt super

 

